1111111111111111111111111111111111
1E0000000000000C00000C000000000001
1000101010010000010100100000001011
1010010010101010001001000000010101
1P0000000C00C00000C0000000000000C1
10000001000100C0010000010000010001
10001000010C0001100000001000000001
10001000010C0001100000001000000001
1111111111111111111111111111111111